--------------------
|                 #|
| ---------------| |
| |#             | |
| | -----------| | |
| | |         #| | |
| | | -------| | | |
| | | |      | | | |
| | | | ---| | | | |
| | | | |  | | | | |
| | | | |- | | | | |
| | | |    | | | | |
| | | |----- | | | |
| | |        | | | |
| | |--------- | | |
| |            | | |
| |------------- | |
|#               | |
|----------------- |
|  #              #|
--------------------
 
